0000000000000000000000000000000000000000000000000000000000000000
0000000000000000000000000000000000000000000000000000000000000000
0000000000000000000000000000000000000000000000000000000000000000
000x111111111111111111111111111111111111111111111111111111112000
0001111111111111111111111111111111111111111111111111111111111000
0001111111111111111111111111111111111111111111111111111111111000
0001111111111111111111111111111111111111111111111111111111111000
0001111111111111111111111111111111111111111111111111111111111000
0001111111111111111111111111111111111111111111111111111111111000
0001111111111111111111111111111111111111111111111111111111111000
0001111111111111111111111111111111111111111111111111111111111000
0001111111111111111111111111111111111111111111111111111111111000
0001111111111111111111111111111111111111111111111111111111111000
0001111111111111111111111111111111111111111111111111111111111000
0001111111111111111111111111111111111111111111111111111111111000
0001111111111111111111111111111111111111111111111111111111111000
0001111111111111111111111111111111111111111111111111111111111000
0001111111111111111111111111111111111111111111111111111111111000
0001111111111111111111111111111111111111111111111111111111111000
0001111111111111111111111111111111111111111111111111111111111000
0001111111111111111111111111111111111111111111111111111111111000
0001111111111111111111111111111111111111111111111111111111111000
0001111111111111111111111111111111111111111111111111111111111000
0001111111111111111111111111111111111111111111111111111111111000
0001111111111111111111111111111111111111111111111111111111111000
0001111111111111111111111111111111111111111111111111111111111000
0001111111111111111111111111111111111111111111111111111111111000
0001111111111111111111111111111111111111111111111111111111111000
0001111111111111111111111111111111111111111111111111111111111000
0001111111111111111111111111111111111111111111111111111111111000
0001111111111111111111111111111111111111111111111111111111111000
0001111111111111111111111111111111111111111111111111111111111000
0001111111111111111111111111111111111111111111111111111111111000
0001111111111111111111111111111111111111111111111111111111111000
0001111111111111111111111111111111111111111111111111111111111000
0001111111111111111111111111111111111111111111111111111111111000
0001111111111111111111111111111111111111111111111111111111111000
0001111111111111111111111111111111111111111111111111111111111000
0001111111111111111111111111111111111111111111111111111111111000
0001111111111111111111111111111111111111111111111111111111111000
0001111111111111111111111111111111111111111111111111111111111000
0001111111111111111111111111111111111111111111111111111111111000
0001111111111111111111111111111111111111111111111111111111111000
0001111111111111111111111111111111111111111111111111111111111000
0001111111111111111111111111111111111111111111111111111111111000
0001111111111111111111111111111111111111111111111111111111111000
0002111111111111111111111111111111111111111111111111111111112000
0000000000000000000000000000000000000000000000000000000000000000
0000000000000000000000000000000000000000000000000000000000000000
0000000000000000000000000000000000000000000000000000000000000000